<?xml version="1.0" encoding="utf-8"?>
<MapData xmlns:xsi="http://www.w3.org/2001/XMLSchema-instance" xmlns:xsd="http://www.w3.org/2001/XMLSchema" xmlns="urn:semi-org:xsd.E142-1.V1005.SubstrateMap">
  <Layouts>
    <Layout LayoutId="Strip" DefaultUnits="MM" TopLevel="true">
      <Dimension X="1" Y="1" />
      <DeviceSize X="0" Y="0" Units="MM" />
      <ProductId>IFX2129023AAS000</ProductId>
      <ChildLayouts>
        <ChildLayout LayoutId="Unit" />
      </ChildLayouts>
    </Layout>
    <Layout LayoutId="Unit" DefaultUnits="MM" TopLevel="false">
      <Dimension X="76" Y="16" />
    </Layout>
  </Layouts>
  <Substrates>
    <Substrate SubstrateType="Strip" SubstrateId="S01321832209">
      <LotId>IFX2129023AAS000</LotId>
    </Substrate>
  </Substrates>
  <SubstrateMaps>
    <SubstrateMap SubstrateType="Strip" SubstrateId="S01321832209" LayoutSpecifier="Strip/Unit" SubstrateSide="TopSide" Orientation="0" OriginLocation="UpperRight" AxisDirection="UpRight">
      <Overlay MapName="DownloadBinCodeMap" MapVersion="1">
        <ReferenceDevices />
        <BinCodeMap BinType="Integer2" NullBin="FFFF" MapType="2DArray">
          <BinDefinitions>
            <BinDefinition BinCode="010F" BinCount="262" Pick="false" />
            <BinDefinition BinCode="0100" BinCount="954" Pick="false" />
          </BinDefinitions>
          <BinCode>010F010F010F010F010F010F010F010F010F010F010F010F010001000100010001000100010001000100010001000100010001000100010001000100010001000100010001000100010F010F010F010F010001000100010001000100010001000100010001000100010001000100010001000100010001000100010001000100010001000100010001000100010001000100010001000100</BinCode>
          <BinCode>010F010F010F010F010F010F010F010F010F010F010F010F010001000100010001000100010001000100010001000100010001000100010001000100010001000100010001000100010F010F010F010F010001000100010001000100010001000100010001000100010001000100010001000100010001000100010001000100010001000100010001000100010001000100010001000100</BinCode>
          <BinCode>010F010F010F010F010F010F010F010F010F010F010F010F010001000100010001000100010001000100010001000100010001000100010001000100010F01000100010001000100010F010F010F010F010001000100010001000100010001000100010001000100010001000100010001000100010001000100010001000100010001000100010001000100010001000100010F01000100</BinCode>
          <BinCode>010F010F010F010F010F010F010F010F010F010F010F010F010001000100010001000100010001000100010001000100010001000100010001000100010001000100010001000100010F010F010F010F010001000100010001000100010001000100010001000100010001000100010001000100010001000100010001000100010001000100010001000100010001000100010001000100</BinCode>
          <BinCode>010F010F010F010F010F010F010F010F010F010F010F010F0100010001000100010001000100010F0100010001000100010001000100010001000100010001000100010001000100010F010F010F010F010001000100010001000100010001000100010001000100010001000100010001000100010001000100010001000100010001000100010001000100010001000100010001000100</BinCode>
          <BinCode>010F010F010F010F010F010F010F010F010F010F010F010F010001000100010001000100010001000100010001000100010001000100010001000100010001000100010001000100010F010F010F010F010001000100010001000100010001000100010001000100010001000100010001000100010001000100010001000100010001000100010001000100010001000100010001000100</BinCode>
          <BinCode>010F010F010F010F010F010F010F010F010F010F010F010F010001000100010001000100010001000100010001000100010001000100010001000100010001000100010001000100010F010F010F010F010001000100010001000100010001000100010001000100010001000100010001000100010001000100010001000100010001000100010001000100010001000100010001000100</BinCode>
          <BinCode>010F010F010F010F010F010F010F010F010F010F010F010F010001000100010001000100010001000100010001000100010001000100010001000100010001000100010001000100010F010F010F010F010001000100010001000100010001000100010001000100010001000100010001000100010001000100010001000100010001000100010001000100010001000100010001000100</BinCode>
          <BinCode>010F010F010F010F010F010F010F010F010F010F010F010F010001000100010001000100010001000100010001000100010001000100010001000100010001000100010001000100010F010F010F010F010001000100010001000100010001000100010001000100010001000100010001000100010001000100010001000100010001000100010001000100010001000100010001000100</BinCode>
          <BinCode>010F010F010F010F010F010F010F010F010F010F010F010F010001000100010001000100010001000100010001000100010001000100010001000100010001000100010001000100010F010F010F010F010001000100010001000100010001000100010001000100010001000100010001000100010001000100010001000100010001000100010001000100010001000100010001000100</BinCode>
          <BinCode>010F010F010F010F010F010F010F010F010F010F010F010F01000100010001000100010001000100010001000100010F010001000100010001000100010001000100010001000100010F010F010F010F010001000100010001000100010001000100010001000100010001000100010001000100010001000100010001000100010001000100010001000100010001000100010001000100</BinCode>
          <BinCode>010F010F010F010F010F010F010F010F010F010F010F010F010001000100010001000100010001000100010001000100010001000100010001000100010001000100010001000100010F010F010F010F010001000100010001000100010001000100010001000100010001000100010001000100010001000100010001000100010001000100010001000100010001000100010001000100</BinCode>
          <BinCode>010F010F010F010F010F010F010F010F010F010F010F010F010001000100010001000100010001000100010001000100010001000100010001000100010001000100010001000100010F010F010F010F010001000100010001000100010001000100010001000100010001000100010001000100010001000100010001000100010001000100010001000100010001000100010001000100</BinCode>
          <BinCode>010F010F010F010F010F010F010F010F010F010F010F010F010001000100010001000100010001000100010001000100010001000100010001000100010001000100010001000100010F010F010F010F010001000100010001000100010001000100010001000100010001000100010001000100010001000100010001000100010001000100010001000100010001000100010001000100</BinCode>
          <BinCode>010F010F010F010F010F010F010F010F010F010F010F010F010001000100010001000100010001000100010001000100010001000100010001000100010001000100010001000100010F010F010F010F010001000100010001000100010001000100010001000100010001000100010001000100010001000100010001000100010001000100010001000100010001000100010001000100</BinCode>
          <BinCode>010F010F010F010F010F010F010F010F010F010F010F010F010F0100010001000100010001000100010001000100010001000100010001000100010001000100010F010001000100010F010F010F010F010001000100010001000100010001000100010001000100010001000100010001000100010001000100010001000100010001000100010001000100010001000100010001000100</BinCode>
        </BinCodeMap>
      </Overlay>
    </SubstrateMap>
  </SubstrateMaps>
</MapData>